        PPBP PP PPP PP PB PB PPB
PB PPB P PBB BB PB  P B PB   BPB
B           H BB BBP B P  B  PPP
PPPB       BPB         BB BPB  B
B BBBBB         PBP V P  PP BP B
        P P V    P BBP         P
BB       PPP  P P PPP B BPPP  PP
P BPB B B PPP P  PBP      B PBPB
PP  PPP  BB          PPB  PP  BB
PP   P B P BBB  PB    B BP B PBP
         BBBB B  B  PB         B
P B      H  D     B BP BB  P PPB
P B B BBBBP B BB    P P      BPB
BP PPP    BPB               BPPP
BPBBB  B     BP B               
