5
        PPPPPPPPPPPPPPPPPPPPPPPP
P  PBBPPPPBBBPPPP        PPPPPPP
P  PP               H       BBPP
P        PPPPPPPBBBBBPPPPPPPPPPP
P   V            BBP       H  DP
PPP          PPPBPP        BBPPP
PPBB             VBP        BPPP
PPPPPBBBB                    BBP
PPPPP                          P
PPPPPBBBBBBPPPPBBBBPPBBBBBBBBBBP
P                              P
P       H        P           BBP
P             BBBP     PPPP    P
PPPPPPP         BP              
PPPPPPPPPPPPPPPPPPPPPPPPP  
